28
28
1999999999999999999999999998
7000000000000000000000000007
700p0000000000f0000000000007
70000000000000000000000j0007
7000000000000000000000000007
700000000000000000000f000007
7000t00000000000000000000007
7000000000000000000000000007
7000000000000000000000000007
7000000000000700000000000007
7000007000000u90000000000007
700000u99999-000000000000007
70009-0000000000000000000007
7000070000000000000000000007
70000000000@000000000000@007
7000000000000000000000000007
7000000000000000000000000007
7000000000000000000000000007
7000000000000000000000000007
7000000000000000000000000007
70000000000000000t0000000007
70000t0000000000000000000007
7000000000000000000000000007
7000000000000000000000000007
700000l00000000000t000000007
7000000000000000000000000007
700000@0000n0000000000000007
5999999999999999999999999996