28
28
1999999999999999999999999998
7000000000000000000000000007
700p00000000000000000@000007
7000000000000000000000000007
7000000000000000000000000007
7000000000000000090000000007
7000000000000000000000000007
7000t00000000000000000000007
7000000000000000000000000007
700000000-000000000000000007
7xxxxx09u00000000000000000007
7000000000000000000000000007
7000000000000000000000000007
7000000000000000000000000007
7000000000000000000000000007
700000000000@000000000000007
7000090000000000090900000007
7000c00000000000000000000007
7000000000000000000000000007
7000000000000000000000000007
7000000000000000000000000007
7000000000000000000000000007
7000090000000000000000000007
700000000g0g0g0g0g0090000007
7000000000000000000000000007
700@00000000000000000000@007
7000000000000o00000000000007
5999999999999999999999999996