28
12
<##########################>
%00p00000t0%000000000000000%
%0000000000%000000000000000%
%0000000000%eeeeeeeeeeeeeee%
%0000000000%eeeeeeeeeeeeeee%
%000e0e0e00%000000000000000%
%0000000000%ddddddddddddddd%
%0000000###]00000000000f00@%
%000000@%00000000000@00000@%
%0000000#00000t00000000000@%
%x0k0000d0000e0e0000@00000x%
[##########################]