28
28
1999999999999999999999999998
7000000000000000000000000007
700p000000000000000000@00007
700000000000g700000000000007
7000000000000700000000000007
70000t00000007000000000t0007
7000000000000700t00000000007
70000000000007000000t0000007
7g000000k0000700000000000007
70g00000000007000000g0000007
700g00000000t700000000000007
7000g00000g00700000000000007
70000g00000007f000000000g007
70000000g0000700000000000007
7f00000000000700000000000007
700000000000070t00000g000007
7000000000000700000000000007
700t000000f0070000000000t007
7000000000000700t00000000007
7000000000000700000000000007
700000000000t7000000t0000007
700j00000000070g000000000007
70000000t000070000000000t007
700000000000g700000000000007
7000000000000700000000000007
700k0000g00007wwwwwwwwwwwww7
70000000000007000000000000y7
5999999999999999999999999996