28
28
1999999999999999999999999998
7k00000000000000w0000q000v07
700p000000000000w0000q000007
7000000000000000w0000qqqqqq7
7000000000000000w00000000007
7000000000000000wwwwwwwwwww7
700000t000000000000000000007
7000000000000000000000000007
7000000000000000000t00000007
7000000000000000000000000007
7000000000000000000000000007
70000g0g0g000000000000000007
7000000000000000000000000007
7000000000000000000000000007
7000000000000000000000000007
70000j0000000000000000000007
7000000000000000000000000007
700000000000g0g0g00000000007
7000000000000000000000000007
7000000000000000000000000007
7000000000000000000000000007
7000000000000000000@00000007
7000000000000000000000000007
7000000000000000000000000007
7xxxxx0000000000000000000007
700000000000@000000000000007
7i00000000000000000000000007
5999999999999999999999999996